###############
#.............#
#.....22......#
#.....22......#
#.....22......#
#....t22t.....#
#...111111....#
#...111111....#
#....t22t.....#
#.....22......#
#.....22......#
#.....22......#
#.............#
#.............#
###############