#########################
#..1........22..........#
#..1........22..........#
#..1........22..........#
#..1....................#
#..1....................#
#..1....................#
#########################